Ich bin nach 1945 geboren folgedessen geht mir alles am Arsch vorbei was vor dieser Zeit geschehen ist. Ich fühle mich nicht schuldig und werde es auch niemals tun. Auch werde ich mir niemals eine Mitschuld einreden lassen nur weil ich Deutscher bin.	offense	profanity	none
So hat es in Schweden auch begonnen. Mit Burka ist man auf jedenfall sicherer als in 90ies Outfit. Das waren noch Zeiten.	offense	abuse	none
Wenn die Flugzeugführer Angst haben vor Migranten, müssen die Herrschaften eben in Handschellen abgeschoben werden. Wo sind wir denn?	none	none	none
Vor der Wahl u. nach der Wahl 😂😂😂 Merkel würde beweisen, ES GEHT NOCH SCHLIMMER, denn irre bleibt irre 😜	offense	insult	none
Noch nix von Neusprech und political correctness gehört? Linke zeigen einen an und mobben einen aus der Gesellschaft, wenn man unbequeme Wahrheiten benennt. Man ist ein Hetzer... Im alten Testament nannte man solche Leute Propheten	none	none	none
ja das ist was Kinder so aufem kindergartenspielplatz so anstellen und daraus ist der glaube der Moslems endstanden.	offense	abuse	none
Ich frage mich warum Mein Kampf aber nicht der kleine Terroristenratgeber KORAN verboten war !?!?	offense	abuse	none
Schickt diese ISIS-Schlampe nach Syrien!✈️	offense	abuse	sexism
Ich möchte nicht wissen, wann die Jungs das letzte Mal oder überhaupt mal irgendwas mit wir sind stolz auf Euch gehört haben.Während Ihr Euch nämlich den A..im Ausland aufreisst,feiern die Fachkräfte hier ständig #Koeln.Wir denken an Euch. #timeforchange #AfD	offense	profanity	none
Auf die Bewährung schei.......ss ich!	offense	profanity	none
Eine Entschuldigung würde Rückgrat voraussetzen...in einem derart linksgestrickten und realtätverzerrtem Klima nicht mehr oft zu finden...	offense	abuse	none
Hallo Freunde Absurdistan hat mich wieder. Gerade mit `nem Geschenk für Murksel aus PL zurück. Ein Kopftuch für die Zweitfrau des Sultans😜	offense	abuse	sexism
BILD Lasst die ISIS-Schlampe wo sie ist.Ein Gefährder weniger.	offense	abuse	sexism
Sind selbst Schuld die Dummen Girlies die unbedingt Modell werden wollen,	offense	insult	sexism
Den hätte ich absaufen lassen!	offense	abuse	none
Diese Jugendlichen sind die Politiker der islamischen Parteien von morgen. Das Gedankengut wurd seine Früchte tragen. Steht auf Leute!!!	offense	abuse	none
Freundchen, studiere die Weltgeschichte mal etwas genauer. In jenen Ländern, in denen Vollverschleierung (nur für Frauen) Pflicht ist, gab!!!! Es einst Kultur und #Vielfalt. Vor!!!!! der #Islamisierung. Bevor du jetzt meckerst, geh bitte Frauen im Iran vor Steinigung retten!	offense	abuse	sexism
#Halbneger ( also zum Glück nicht ganzer) und ein gerügter Mitarbeiter - Wieviel Relativismus und Abgestumpftheit, bezahlt vom Steuerzahler, bedarf es eigentlich noch, um klar zu werden, das was nicht stimmt in unserem Land ?! Un’ welche Revolution noma‘ ?	offense	profanity	none
Unsere Gedanken sind heute Abend bei den Opfern vom #Breitscheidplatz und ihren Familien. #Israel steht an der Seite Deutschlands. #Berlin	none	none	none
Ich suche eine bezahlbare Wohnung für eine junge Familie mit 2Kindern. Ist unmöglich da alle von Asylanten beansprucht werden und unser Staat auch Mieten ,wie hoch sie sein mögen,von unseren Steuern bezahlt !	offense	abuse	none
gut. dann macht jetzt in der eu jeder was er will... solange es ihre linie ist, finden sie das bestimmt prima.	none	none	none
..wurdest Du Luder Du nicht mit Rede.-und Schreibverbot belegt ..? Berlin Berlin....Migranten überall...im Rathaus und auf Straßen...ne richtige Kanackenstadt geworden..oder heißt es Kanackenstaat..	offense	abuse	sexism
Machtgerangel in Deutschland, zum Kotz**, nur nicht auf den Gedanken kommen für das Dem Deutschen Volke zu wirken, Willkommen im Schland 😜	offense	profanity	none
An alle Pferde Hunde Katzen Kühe usw....ihr seid voll im Arsch...!	offense	profanity	none
Deutsche Medien, Halbwahrheiten und einseitige Betrachtung, wie bei allen vom Staat finanzierten billigen Propagandainstitutionen 😜	offense	abuse	none
Laut Infos des Bayrischen Flüchtlingsrats geht der nächste Abschiebungsflug aller Voraussicht nach am 27.3. von MÜNCHEN nach #Afghanistan.	none	none	none
Bin wieder zu Hause in meinem Mecklenburg - in Szczecin meinte man, Murksel bekam heute die Aufmerksamkeit in Washington, die sie verdient 😜	offense	insult	none
Einem Kind Geräusche zu verbieten sei etwa so unmöglich, wie einem Afrikaner seine Hautfarbe zu verbieten. Harald Martenstein	none	none	none
Wenn das schon alle behaupten....wieso ist die alte noch immer auf freiem Fuß...?	offense	insult	sexism
Sie wissen aber, um welche Zahlen es sich da dreht?	none	none	none
Weil sich mit den Heulsusen niemand fotografieren lässt, sind die traurig...😂😂😂	none	none	none
Wo kriegen die nur ihr Slogans ihre Schlagwörter her...? 😂😂😂😂😂	none	none	none
Das meiste geht eh wieder für die Asylanten drauf 🤮	offense	abuse	none
Das ist eine Moslem-Schlampe , die es hoffentlich noch bereuen wird .Ich habe kein Mitleid nur Schadenfreude!	offense	abuse	sexism
Der Luther wird sich im Grabe rumdrehen!	none	none	none
Yoh. Vorauseilender Gehorsam, der eigentlich nichts anderes ist als Angst, welche aus dem Wissen resultiert, es mit einem unberechenbaren Bösewicht zu tun zu haben. Konfrontation und klare Kante wie die Ösis kriegen die Deutschen nicht mehr hin... Kastriertes Dummvolk	offense	insult	none
Da der Islam im Grunde eine Rassistische Ideologie ist kann sie kein Theologe sein. Eher eine verwirrte Deutsche die sich gerne Lumpen auf den Kopf legt und sich Sharia gemäß gern von ihrem Mann falsch vorhanden verprügeln lässt.	offense	abuse	sexism
RAUS MIT DIESEN IRREN AUS DEM BUNDESTAG, sollen ihre Konfettischwulenparaden woanders feiern, am besten in Türkei bei Özdingens !	offense	abuse	none
Ist doch wahr, denn dieses dicke Etwas bekommt kaum zwei zusammenhängenden Sätze heraus und von sinnvoll rede ich garnicht erst 😜	offense	abuse	none
Ursprünglich (gestern) ging es um FEMA-Camps - wir sind keinen Schritt weiter. Da platzt einem der Arsch - sorry.	offense	profanity	none
Der in der „Man kann gegen die viel sagen, aber sie organisiert selbst den Auszug aus der Regierungsbildung immer noch professioneller als die ihren allmählichen Einzug.“	none	none	none
Jede verdammte Einsatzbesprechung vor Schichtantritt ist eine verdammte Interne Anweisung und ich meine I A =ähnlich Schreiben! Lüge??nö!!	offense	profanity	none
Kahane, Extremismus-Expertin??? 😂😂😂 Hinterlistig schnüffeln, wie ein Trüffelschwein trifft`s eher 😜	offense	insult	none
Mit Europa im Zentrum meinen die Polit🤡 wohl die verrottete, korrupte #EU	offense	insult	none
😂😂😂 Phantomschmerz (fehlende Eier) und Machtgeilheit zwangen heute erneut den Bayern-Horsti ohne Vaseline in den Ar*** der Kanzlerette 😜	offense	insult	sexism
Dummes Geschwätz von Kern. Er ist für Lösungen. Bin ich auch. Unfähige Nulltipper davonjagen. Die Wahlen kommen.	offense	abuse	none
Die ganze Welt schüttelt den Kopf oder lacht uns aus und dieses dumme Weib, Merkel, macht fleißig weiter !	offense	insult	sexism
Warum veröffentlicht ihr keine Bilder von linken Anarchisten?Die gibt es zuhauf!Aber ihr seit nur ein Unterstützer dieser Horden!	offense	abuse	none
Es gibt bei uns keine Pressefreiheit mehr. Wir sind eine Bananenrepublik wie Simbabwe!	offense	abuse	none
Der Unterschied zwischen Udo Jürgens und Conchita zeigt wie sehr sich Europa in 4 Jahrzehnte gewandelt hat. Lebt damit!	none	none	none
Weil es kleine fotzen.sind Kamerad!!	offense	insult	sexism
Schwach ist,wer sich nicht um Land u Volk kümmert,dann übernahmen schon immer andere die Macht,das beweist d. gesamte Menschheitsgeschichte😜	none	none	none
Was haben deutsche mit dem Islam zu tun??	none	none	none
Lese gerade bei Akif das die komische Ich auch-Debatte noch läuft !! Meine Lebensgefährtin sagte das es auffallend sei das die Frauen die jetzt die Klappe aufreißen erst ab einem bestimmten Karrieregrad nun meinen das sie die Scheere nicht aufmachen wollten! Soviel dazu!	offense	abuse	sexism
Mit Grünen Verrückten kann man nicht diskutieren!!!!	offense	abuse	none
Für den zensierten Scheiss auch noch mehr bezahlen? So eine Unverschämtheit.Freie Senderwahl ich bezahl nur die Sender die ich sehen will.	offense	profanity	none
Wir werden auf Jahre hin verseucht.....dieses Unkraut, auch dieses in den eigenen Reihen, kriegen wir nie wieder los...!!	offense	abuse	none
Ich habe mal geträumt,ja ein Albtraum, ich wäre der SED-Stasi-Trulla auf Ohrfeigenabstand nahe gekommen und mit jedem Watschen wurde sie häßlicher und gruseliger. Erst als ich die Faust einsetzte bekam ihre Horrorfratze die Schönheit die sie verdient !	offense	abuse	sexism
Vasallen schweigt und kriecht weiter, was ihr ja schon seit Jahren macht!	offense	insult	none
Heilige FÄKALIEN, da läuft gerade Anne Will(schön sein) auf 3SAT!Keine Ahnung ob Wiederholung oder so,iss auch egal ! NUR SO EINEN HAUFEN GEMEINSCHMUTZIGER DUMMHEIT HAB ich selten gesehen ! Spiegelt voll den ZUSTAND DEUTSCHLANDS ! BÖSER TRUMP, SUPER MUSLIME !	offense	abuse	sexism
Hallo, war einige Tage in PL, bin gerade zurück u. muss erst all die positiven Eindrücke verarbeiten😜Horsti u. Murksel, ein Thema in PL 😂😂😂	offense	insult	none
Der beste Beweis dafür das man auch ohne Hirn aufrecht stehen kann....das ist unterirdisch das ist eines Politiker unwürdig Wie kann diese Frau nur so dumm und dämlich sein...??	offense	abuse	sexism
Infotweet: Antifaschisten sind alle vernachlässigte Scheidungskinder	offense	insult	none
Sag mal glaubt ihr allen Ernstes die Kacke dieser sogenannten Umfragen, mal ehrlich??	offense	profanity	none
Kleinstaat Tschechei läßt keine Moslems in Land. Die #EU schon. Also lieber Kleinstaat der Interessen seiner Bürger vertritt	none	none	none
ich habe geschrieben Zwang GEZ und Inhalte ARD ZDF sind zu kritisieren	none	none	none
....die lächerliste Person seit es die Linken gibt. Mit einem Maulkorb für Katja wäre es ruhiger um die Linken und zudem wäre sie dann attraktiver...!	offense	abuse	sexism
Verdammt nochmal, Ihr Italiener. Schließt endlich Eure Häfen für ShuttleschiffeWir brauchen keine illegalen Einwanderer.	offense	profanity	none
Von der Leyen soll sich endlich um ihre Kinder kümmern. Ab an den Herd. In ihrem Job absolut unfähig.	offense	abuse	sexism
Tja, entweder hat früher gelogen und sich verstellt, oder er war nie anders - mich langweilt der Scheiß enorm. Ich guck gleich zu meinen Nicht-Deutschen Followern - das ist interessant und aufbauend.	offense	profanity	none
...worauf du einen lassen kannst....ich war Gestern dein Feind bin es heute und werde es auch in Zukunft sein..! Wir brauchen ganz sicher etwas....aber dich nicht...!!	offense	profanity	none
Habt ihr schon in Erwägung gezogen das die Wahlen nur reine Verarsche sind, seit 1949 sind immer die gleichen Volksverräter dran, wie blöd kann man sein und das nicht irgendwann zu durchschauen ‼️	offense	abuse	none
Mal sehen...wenn ich jetzt schreiben würde mann soll Flüchtlinge würgen dann werde ich bestimmt gesperrt..?	offense	abuse	none
Ich schlage vor jedem Abgeordneten im Bundestag den Koran zur Pflicht Lektüre werden zu lassen. 90%kennen ihn gar nicht.	none	none	none
Frankreich werden 10 GOLDENE JAHRE vorhergesagt ! Kein Wunder, Matschbirne Schulz will ja unser Geld verschenken! Der dumme DEUTSCHE macht das ja ! Langsam bekomme ich Magengeschwüre und weiß nicht mehr wohin mit meiner WUT !	offense	insult	none
Selbstverständlich. Fett gepamperte Zugpferde sämtlicher arabischer Islamlobbys. Wenn diese am Ziel sind, werden die Damen unter das Kopftuch entsorgt	offense	abuse	sexism
Die setzt statt auf Aus Bildung und Berufserfahrung auf Qoutenweiber. #Sozenversenken	offense	insult	sexism
Tja wenn man kooperiert und Mitstreiter verrät,gibts als Belohnung Freispruch!	none	none	none
Hab gerade ein paar Ausschnitte dusselige Will geschaut lol ! Klasse Weidel , die Blödmänner gehen wie Besenbinder aufeinander los !👍🏻👍🏻👍🏻👍🏻	offense	insult	none
Wir hatten keine Probleme in der Truppe. Es gab keine Frauen in der Truppe, und das war gut so.	offense	abuse	sexism
#illner Das Söder nun auf #AfD Programm macht und die Wahrheit ausspricht,welche nur bei der AfD rassistisch und polemisch,bei Söder aber bürgernahe Erkenntnis ist,scheint #87Prozent überhaupt nicht zu stören. Ja...so sind sie.Die Heuchler und Doppelmoraler.	offense	insult	none
#Mobbing an Schulen setzt sich jetzt in der Politik fort Altparteien sprechen alle nicht mit der #AfD sondern nur abfällig(Nazi) über sie	offense	profanity	none
Schon ein Wahnsinn....obwohl nichtmal 1/3 der Bevölkerung sie gewählt hat darf sie trotzdem weiter regieren. Ist zum kotzen!	offense	profanity	none
Es reicht wenn sie lächelt, wirkt zwar nicht intelligenter ist aber angenehmen für die drumrum ....!	offense	insult	sexism
Sie können gelassen auf jeden Polit-Idioten warten, der auch einen Krieg nur in Erwägung zieht 😜	offense	insult	none
G20 ist geplante Verarschung von #Merkel Die Gewaltexzesse sichern ihren nächsten Wahlsieg Außer Spesen nix gewesen	offense	insult	none
Weil diese Antifantenbrut nicht ihre Gesichter zeigt! Solche Linksversifften Menschen gehören nicht auf die Straße sondern .... *zensiert*!	offense	abuse	none
Solange solch Polit-Pfeifen, wie Murksel u. ihre Muschpoke bestimmen, was RECHTS ist, läuft mir das am Ars** vorbei - dieses verlogene Pack😜	offense	abuse	none
Eine Frage die sich jeder stellt.	none	none	none
damit ihnen alle nach dem mund quatschen? stimmt, dann wirds bestimmt besser... #ironie off aber gut, hatten wir ja alles schon mal 🧐	none	none	none
Oh Gott, sehe gerade Laschet in den n-tv Nachrichten, ich glaube ich muss ko***, mir ist schlecht 🤢🤢🤢	offense	insult	none
melde dich doch, ich war noch da 😎	none	none	none
Aber ein Bildausschnitt reicht, um Mio Wähler zu überzeugen &gt; bewusste Manipulation der Leser dieser Lügenpresse 😜	offense	abuse	none
Könntet ihr mich bitte aus dem Thread rausnehmen, das Klugscheißern von Ao und dessen oberlehrerhaften Bevormundungen gehen einem langsam auf den Sack. Danke	offense	insult	none
Bin 1947 geboren und habe mit diesem ganzen Scheiß nichts am Hut! Basta!	offense	profanity	none
Genau...und wir haben zu viele Arschlöcher..!	offense	profanity	none
Es ist zum Kotzen, seit Tagen!	offense	profanity	none
Keine Strafen für türkische Doppelstaatsbürger. Sofortige Aberkennung der österr. Staatsbürgerschaft, und ab damit ins Sultanat.	offense	abuse	none
Früher...schon viel früher... Schade das die Verantwortlichen bis dahin schon abgekratzt sind....früher wäre besser	offense	profanity	none
Kann man diesen ganzen Scheiß noch glauben..?	offense	profanity	none
Ein weiterer Grund, den ich häufig erlebe, ist, dass es zu wenig Männer (richtige Männer 😉) im Schuldienst gibt. Erfolgreicher Unterricht ist vor allem auch Identifikation. Mädchen lieben mich, Jungen rebellieren...	offense	insult	sexism
Kann dir keine direkt Nachrichten senden wasn los???	none	none	none
ZF Erdowahn und seine Koran und Sharia Treue Gemeinde sind die schlimmsten Rassisten. Wir haben dem Islam heute den Krieg erklärt. Wir haben diese Spinner 800Jahre gewarnt. Jetzt ist Schluss mit Lustig. ++ Deus Vult +++	offense	abuse	none
Wenn Trump der neue Hitler ist, Was ist dann Clinton?? Clinton Der Antichrist !!!!	offense	abuse	none
Wacht endlich auf, denkt an die Zukunft eurer Kinder. Oder möchtet ihr eure Töchter mit Kopftuch und mit 12 verheiratet sehen? Ich nicht, darum wähle ich AFD! #illner	offense	abuse	sexism
Abnehmen hat sich nicht gelohnt...fett weg Hirn weg...!	offense	abuse	none
An Merkel, Gauck, Flintenuschi &amp; Co: Wer Krieg predigt, ist des Teufels Feldprediger (altes Deutsches Sprichwort) 😜	offense	insult	sexism
Ja das ist das Ergebnis wenn blinde auf taube treffen....und das die nächsten 4 Jahre...holly shit	offense	insult	none
Pure Verzweiflung 😂😂😂 das würde sich nicht einmal ein Nafri antun, nehmen eher zur Not `ne Ziege 😂😂😂	offense	abuse	none
Einweisen ...dafür gibt’s die geschlossenen... Und den der diese alte hübsch findet oder gar erotisch....ebenfalls..! ....im Land ihresgleichen bestimmt der Renner...😃😃	offense	abuse	sexism
Flintenuschi kam heute in der Berliner Gedächtniskirche groß raus 😂😂😂 wo sie doch ihre Kriege u. ihre Söldner so liebt. 😂😂😂	offense	insult	sexism
Dieses Schwein darf nicht abgeschoben werden...noch nicht...der soll erst seine Strafe absitzen und deutscher Knast ist kein Urlaub. Dafür bezahle ich gerne extra...!	offense	insult	none
Beitrittserklärungen nimmt zukünftig #Pfarrer/#Pfarrerin entgegen; Zustimmung #Kirchenvorstand nicht notwendig #altkatholisch #aksynode16	none	none	none
Wer schützt eigentlich psychisch Kranke Menschen vor pauschalen Vorurteilen?	none	none	none
Heute wird “Unwort des Jahres” bekanntgegeben. Wie wärs mit „Fresse“, „Kacke“ oder „Bätschi”? 😂	offense	profanity	none
Leute regt euch nicht auf....negative Berichte haben eine positive Wirkung....AfD bleibt und wird stärker Wie sagte die komische Kuh von den Grünen...und ich freu mich darauf....😂😂	offense	insult	none
Es nervt tierisch. Bitte löscht die doch mal - die klauen euch die Zeit und sind resistent gegen alles, vor allem Bildung. Kruzifixnochmal!	none	none	none
Es ist eindeutig und unmissverständlich.....unsere humanitäre Haltung ist falsch naiv und dumm, vollkommen im Arsch.	offense	profanity	none
Und was haben wir Deutsche für Rechte ?Wir sind die Leidtragenden im Buntland!	offense	abuse	none
Merkel hat soviel Ahnung vom Auto, wie die berühmte Kuh vom Sonntag!	offense	insult	none
Das ist vollkommen richtig und kann nur so diesen Irrsinn Wirtschaftsflüchtlinge stoppen!	offense	abuse	none
OMG.....was für eine ekelhaft häßliche Frau..dieses Gesicht nur auf dem Boden einer Mülltonne zu gebrauchen...!	offense	insult	sexism
Dass wir diese ganzen IS-Kämpfer haben ist ausschließlich die Schuld der Amerikaner. Scheinheiliges Volk.	offense	insult	none
Auf allen Sendern wieder ein einseitiges und völlig verfälschtes Geschichtsbild (Bsp. ntv) &gt; zum KOT*** 🤢	offense	profanity	none
Weiterhin: Die telefonische Beratung ist nur ein Teil unserer Arbeit. Die gibt es schon seit Jahrzehnten. Was heißt das? Auch für den Bestand dieses Angebots ist die Zahl der Flüchtlinge irrelevant.	none	none	none
Stimmt aber dazu ist er zu blöde.	offense	insult	none
n-tv: Startschwierigkeiten bei Antiterror-Übung &gt; Ich: Wenn Dilettanten unter Flintenuschis Obhut schon Krieg spielen! 😂😂😂	offense	insult	sexism
Sie sind ein Steuerbetrüger und haben die einzige demokratische Partei Deutschlands AfD, nicht zu beleidigen! Bald sind Sie verschwunden!	offense	insult	none
Die SPD ist heute so überflüssig wie die Haare an meinen Arsch. Die neue Volkspartei ist die AFD. #illner	offense	profanity	none
Es ist und bleibt was es ist....illegal..! Gebt Ihnen was zu essen was zu trinken...und statt die gleiche beschwerliche Rückreise einen angenehmen Rückflug..!	none	none	none
Wir machen dies Frau bis zur Wahl im September fertig!! Zeigen wir der Welt wer diese Volksverräterin wirklich ist!!	offense	abuse	none
Was ist jetzt der Vorwurf an mich?	none	none	none
Mich besorgt das Säbelrasseln gegen RU. Ich kenne das russ. Militär v. 1974-1988 sehr gut u. glauben Sie, d. NATO ist KEIN Gegner.	none	none	none
Salvatore, siehst Du nicht, wer da aus Afrika kommt? Wenn Du diese rücksichtslosen Invasoren willst, dann füttere sie selbst, und sitz.	offense	abuse	none
Italien will anderen Staaten illegal Eingereiste aufzwingen anstatt sie zurückzuschicken. Sie haben kein Recht auf Asyl, verdammt.	offense	profanity	none
Familienrückführung statt Familiennachzug....das wäre das einzig logische vernünftige und anständige. Alles andere ist Menschendiebstahl...!	offense	abuse	none
Früher war in der Bronx sicherer als heute in DE	none	none	none
Wenn Merkel die Geschichte d. USA kennen würde, wüsste sie, dass d. USA kein Interesse an einem starken Europa mit einer Kanzlerette haben 😜	none	none	sexism
MERKEL MUß WEG !! UND DAS SCHNELL UND RÜCKSTANDSLOS !! DIESER GRÖßENWAHNSINNIGE ALKOHOLIKER SCHULZ DARF HIER NICHTS ZU SAGEN HABEN, AUßER IN DER GESCHLOSENEN! DAS DARF DOCH ALLES NICHT WAHR SEIN !	offense	abuse	none
Im Grunde ist es fast psychopathisch, wie Trump ständig überprüft wird. Habt ihr Säcke auch schon seinen Stuhlgang überprüft?	offense	insult	none
Dortmund:Leipzig Die großmäuligen Dortmunder werden von Leipzig hergespielt. Großartig!	offense	insult	none
Für Kinderfickerei gibt es keine Härtefälle Hier gelten Deutsche Gesetze und sonst nichts!	offense	profanity	none
33 bis 45 habe ich noch gar nicht gelebt und es geht mir am Arsch vorbei was in dieser Zeit geschehen ist. Ich lebe im heute und jetzt und nicht in der Vergangenheit.	offense	profanity	none
Das ist mir scheiss-egal Hauptsache sie scheiden aus ,bin 60er Fan!!!!!!!!!	offense	profanity	none
Bei wem haben die die Umfrage gemacht, euch kann man jeden Scheiß erzählen ihr glaubt einfach alles was die Systemmedien euch weiß machen	offense	profanity	none
Für d Schweinejournalisten Pack von ARD u ZDF ist es Hetze wenn man d tatsächlichen Zustände in diesem Merkeltollhaus anprangert Jetzt AFD	offense	abuse	none
Die Caritativen Einrichtungen sind mir jetzt sowas von scheissegal! Habe Austritt aus der Kirch beantragt.!!!!!!!!	offense	profanity	none
MEIN GOTT ! WAS HAT DIE SED-TRULLA MIT HILFE VON LINKEN U-BOOTEN AUS DEUTSCHLAND GEMACHT !?!? DAS DAS DAS DURFTE !!	offense	abuse	sexism
Wer Andersgläubig oder Immigrant ist erhält dafür Bewährung bei harten Straftaten! LÄUFT DOCH IN D!	offense	abuse	none
Die Türken dringen hier ein und wollen uns ihre Art zu leben aufzwingen. Und beschimpfen unsere entscheidungsunfähigen Weicheier als Nazis.	offense	abuse	none
Wenn Hacker die Bundestagswahl beeinflussen sollen, ist Merkel die Leithäckerin &gt; sie hackt sich den Stuhl unter`m gewaltigen Arsch weg 😂😂😂	offense	insult	sexism
Achja ... und steckt euch euren - in Wahrheit RASSISTISCHEN - #diversity-Scheißdreck sonstwohin ...	offense	profanity	none
Antrag 29 wird an die Rechtskommission überwiesen - #aksynode16	none	none	none
Die Linke ist auch eine Nachfolger Partei der SED abschaffen? Auf jedenfalls eher als den 1.Mai.	none	none	none
Rüstungsausgaben NATO ca. 900 Milliarden, Russland ca. 66 Milliarden. Welchem Idioten wollen die Berliner Hirne einreden, RU sei aggressiv 😜	offense	profanity	none
Danke, dass ihr verlinkt habt. Allerdings haben 286 Menschen vermittelt und nicht 80!	none	none	none
Irgend ein Idiot hat sich über die „Feuerzangenbowle „ aufgeregt weil dieser Film während der Nazizeit gedreht wurde.Was. Ist mit den Bestsellers wie „Emil und die Detektive „ Pünktchen und Anton „oder „das fliegende Klassenzimmer „von Erich Kästner.	offense	profanity	none
Streit um Flüchtlings-Obergrenze - So könnten CDU und CSU ihr Gesicht wahren 😜 Wenn eine hässliche Fratze gemeint ist, geht`s 😜	offense	insult	none
Eine dumme Labertasche dieser ...	offense	insult	none
Die hätte man früher als Hexe verbrannt.	offense	abuse	sexism
Gummigeschosse auf die Birnen von marodierenden Demonstranten. Dann werden sie fliehen und die Ärsche retten wollen.	offense	abuse	none
Wenn der Islam in Europa wirklich eines Tages die Überhand gewinnt, dann werden die linksgrünen Bahnhofsklatscher die ersten sein die ihre Köpfe verlieren. Denn auch der Islam hasst Verräter.	offense	abuse	none
Netanyahu als durchgeknallter Führer &amp; Israel brutale Unterdrückung vorwerfen. Wie konnte das passieren? Wer ist verantwortlich?	none	none	none
Deutschlands Zukunft wird am Hindukusch entschieden #SPD Zitat Das stimmt. Wir haben dort verloren. Jetzt fluten die Afganen nach Deutschland und zerstören es von innen.	offense	abuse	none
Einheimische hassen ihr eigenes Volk und würden alles für fremde tun das gibt es nur in Deutschland	offense	abuse	none
Sippenhaftung. Alles, was mit Islamismus zu tun hat -- aus Europa davonjagen---.Sofort. Wie damals die Türken im 17. Jh. vor Wien.	offense	abuse	none
wenn sie das so sehen, ist das ihr problem. mir jedenfalls geht es nicht ums vorführen.... stellen sie sich eine person im studio vor, die sie sehr kritisch sehen. da wollen sie dann doch auch, dass wir ordentlich nachfragen. die gegenseite einnehmen. oder nicht?	none	none	none
Wenn die Grünen Stinktiere in Deutschland verschwinden im September, wird Deutschlands Luft enorm besser werden!	offense	abuse	none
Die CDU und andere Parteien sind ein verlogener Haufen Politiker die sich die Taschen auf Steuerzahlers Kosten voll machen! 😨	offense	abuse	none
Wir werden überall benachteiligt. Viele Mütter in Leipzig suchen seit Jahren Kindergartenplätze. Die Neuhinzugekommenen aus Arabien kriegen ihn hinterhergeworfen. Vong Integration wegen...	none	none	none
Warum kehren denn die schieße Türken nicht ins ihr Land zurück?	offense	abuse	none
Das Thema Klima ist bei den Grünen allzeit beliebt...früher sprachen sie sogar von einer Klimakatastrophe...😂 Viel Ahnung von nichts..!	none	none	none
Wenn du sicher gehen möchtest dass sich keine Frau von dir sexistisch behandelt fühlt, dann spricht doch einfach mit keiner mehr. #MeToo	offense	abuse	sexism
Der „Beamte“ , du meinst einen bewaffneten Uniformierten von der Firma mit der Wortmarke POLIZEI ‼️	none	none	none
Alles zu maskulinistisch!! Die Kinder brauchen mehr #Genderwahn. Der Fladen muss also eine VaginaMütze und ein BallettTutu tragen. Über der Burka, selbstverständlich.	offense	abuse	sexism
Hab gerade N24 am laufen und glaube die Alte,also die Sprecherin, hat den TÜRKENdöner als DEUTSCHES NATIONALGERICHT bezeichnet !! Ja wo gibts denn sowas? Ich kenne keine DEUTSCHE Pommesbude die diesen Moslemtoast verkauft ! MEINE FRESSE geht hier ein Scheiß ab !	offense	abuse	sexism
Bald haben wir in Berlin Einen Imam als Bürgermeister.RRG haben abgewirtschaftet .Am besten wäre es wenn wir eine Mauer um Berlin ziehen,um das Pack mitsamt der Meck-Pomm Schlampe zu isolieren ,aber bitte keine Care-Paketflieger schicken!	offense	abuse	sexism
Wenn ich die gesamten deutschfeindlichen Labereien von Oppermann, Stegner usw. hier aufführen würde, knallte der Server durch!	offense	insult	none
😂😂 Wie die SPD ler bei Erdogan und anderen Terror Türken	offense	abuse	none
EU und dieses Schland mischen sich wieder MIT VERLOGENEN DARSTELLUNGEN in die Innenpolitik Polens ein &gt; DAS GEHT IHNEN EINEN SCHEISSDRECK AN	offense	profanity	none
Hab ich auch nicht verstanden :-)	none	none	none
Ich weiß zwar nicht, was Altmaier heute wieder geraucht hat, aber es wird im mögl. Konflikt keine GEWINNER mehr geben 😜	offense	insult	none
Du weißt doch, ich kann nicht anders 😜	none	none	none
Zum #Iran sich ausschweigen, aber #Israel, die einzige #Demokratie in der #Levante, einen Apartheidstaat nennen, ist purer #Antisemitismus! Die #SPD hat ja anscheinend einige Kandidaten, wie #Schulz, #Gabriel &amp; #Steinmeier. Eine #GroKo 2.0 Regierung wird #Deutschland schaden!	none	none	none
Beinah hätten Sie recht: 3021 wär das Datum, wenn Rot-Rot-Grün demnächst regieren würde! :-)	none	none	none
Deutsche Rentner müssen Flaschen sammeln und die Grünen labern was von Klimaschutz.	offense	profanity	none
Und wenn schon, weiß doch jeder halbwegs schlaue was gemeint ist ! Gammatikfehlersuche ist eigentlich ein linkes Ding!	none	none	none
Die ganze Welt mutiert zum Kindergarten. Trump hat ein Shithole Shithole genannt. Jetzt dürfen alle Shithole Bewohner -anstatt das Shithole aufzuräumen - beleidigt alle Stühle umschmeissen, Flaggen verbrennen und Weiße abschlachten.	offense	profanity	none
Vielmehr - Liebe passiert manchmal einfach. Sie fragt nicht: Wer bist du und wie definierst du dich? Sie geschieht.	none	none	none
Bei Familienfragen kennt sich die Alte bestens aus... Wenn wir schon familienfreundlich handeln wollen gibt es bessere Lösungen: Keine Einreise für Alleinstehende..!	offense	insult	sexism
Der erste Satz von Kurz schon symptomatisch bezeichnend, das merkelsche Einhornschloß enlarvend: nun, wir wußten schon ziemlich früh, wohin die Reise geht #Maischberger	offense	insult	none
Wir brauchen dringend einen RESET der MsM und des Grundschulsystems ohne diese verfluchten Handsockenpuppen schwingenden ÖkoAntifaFeministinnen ! DRINGLICHST !!	offense	insult	sexism
Ich werde Opa. Es gibt sogar noch schöne Dinge im Leben!!!!	none	none	none
Schickt unsere Verdeidigungsministerin als Stangengirl zur Truppenbetreuung an die Front ,aber selbst dort wird sie Versagen.Eine Verteidigungsministerin ist Ein Hohn an die Truppe.Rommel wache auf!	offense	insult	sexism
Weihnachten ade....es war einmal . Dieses zu bereinigen wäre immer noch möglich...doch wir tun es nicht, wir nehmen es einfach hin. Wir werden von dummen schwachen naiven regiert...und die haben soviele Helfershelfer.	offense	insult	none
Mach ma weiter so #gabriel macht scheinbar alles für den #erdogan . #fckerdogan #ErdoganTheButcher #erdoganistderhass	offense	insult	none
Also wenn die Türken bei euch so kacke sind kann ich auch nix machen 😂	offense	profanity	none
Der Typ hat sich mit etlichen hier angelegt, hat inhaltlich nichts zu bieten - nur Klugscheißern. Eigenes hat er auch nicht zu bieten - dafür reicht sein Intellekt nicht.	offense	insult	none
Hey Leute, wir haben so lange die Warzentusse ertragen...das mit dem Kleinwüchsigem kriegen wir auch hin...	offense	insult	sexism
Stimmt....aber Köln ist nicht minder zu bemitleiden 😃😃	none	none	none
Die Diskussionen zwischen #Augstein &amp; #Blome spiegeln wunderbar die dekadente geistige Verblödung der politischen Presse wieder	offense	insult	none
Dummheit ist in Deutschland seit Stasi-Merkel, weit verbreitet! Übrigens das war sie bei Adolf ebenso und wir wissen alle wohin das führte!	offense	abuse	none
Kümmert die einen feuchten D....	offense	profanity	none
Die Kanackenweiber sind die schlimmsten....	offense	abuse	sexism
Wenn das zustande kommt müßte es eigentlich jeder merken das wir übergangen werden....! Das ist keine Volksentscheidung ...das ist nicht Wählerwille ..!! Verfluchte Scheisse...😡😡	offense	profanity	none
Die bayerische Labertrumpe ist wieder am Werk! Wenn Merkel sich räuspert, ist wieder Ruhe im Duckmäuser-Staat!	offense	insult	none
Deswegen unterstützen Sie auch Kinderehen?! Kotz!	offense	profanity	none
Kotz deine Propaganda wo anders aus. Hier bist du falsch.	offense	insult	none
Eine Partei in der #AfD-Mitglieder SS-Verbrecher verherrlichen (#Magdeburg), #Holocaust-Leugner relativieren (#Höcke über #Havermann), oder lupenreinen #Antisemitismus verbreiten (#Gedeon ist weiter Mitglied) kann keine Partei für uns #Juden sein. Die #LuegenAfD ist abzulehnen!	offense	insult	none
Warum hört ihr denen noch zu, was habt ihr von Profilügnern erwartet ⁉️	offense	insult	none
Da die Kirche jeher den Herrschenden in den Arsch gekrochen ist, inkl. Hitler, wundert es mich nicht 😜	offense	profanity	none
Es gibt so unendlich viele Vollspacken, da hilft kein Arzt mehr! 😉👎	offense	profanity	none
Wie lange wollt ihr uns eigentlich noch verarschen? #illner	offense	profanity	none
Mensch, Kauder müsste sich doch bepissen vor lachen, wenn er über diese Lüge nachdenkt 😂😂😂	offense	profanity	none
Warum berichtet ihr dann nicht über Merkel!!! An Verbrechen gibt es da ja wohl genug!!	offense	abuse	none
Hetze, Wahlbeeinflussung in den USA u. GB, DAS IST DIESES SCHEISSLAND!!! Ach so, aber der Putin ist ja SCHULD 😂😂😂	offense	profanity	none
Moin, Hat schon einer gemerkt das die ganzen Syrer wieder gehen können ??? Auch die hyperpigmentierten Schwarzafrikanischen SYRER können auch wieder nach Hause ! Da die Politik das nicht propagiert kann man wohl von gewollten Austausch reden !	offense	abuse	none
Die Linken Gender- und meetooidioten die du in den Staaten kennst, natürlich nicht.	offense	insult	none
Allein die Stimme der ZDF-Slomka bringt mich alten Mann zum ko***, ganz abgesehen von ihren hirnlosen Kommentaren &gt; unterste Schublade 😜	offense	insult	sexism
Wieviel Wasser ist im Kopf von	offense	insult	none
Es gibt nur ein Maas das ist ein Mittelmaß und heißt auch so	offense	insult	none
Selbst die Lüge, das es keinen Anstieg der Kriminalität in Altena gibt ist mit wenigen klicks im Netz wiederlegbar	none	none	none
Ohne #Alkohol gäbe es keinen #Alkoholismus Ohne #Islam gäbe es keinen #Islamismus Beides muss weg	offense	abuse	none
Grüne gehören einfach nicht in Regierungs Verantwortung. Schon gar nicht diese Ost Schabracke	offense	insult	sexism
Hilfe...@zeitonline treibt wieder ihr Unwesen... Da sind schon Schmierfinke am Werke...glaubt tatsächlich noch jemand diesen Unfug...?	offense	insult	none
Hatte schon Angst das ich ab jetzt nur noch an den Baum oder in die Hecke pissen darf.	offense	profanity	none
Ja. Da fehlen dir noch 2. Und die müssen nicht im Kreis w..retweeten, sondern hinausziehen zu den Barbaren und ihnen das Evangelium predigen. Also z.B zu den Mullahs, die gerade eine Frau steinigen, weil ihr Kopftuch verrutscht ist.	offense	abuse	sexism
Einerseits:einen Scheiß MÜSSEN wir. Andererseits:ausser permanent darauf hinweisen, nerven, die Öffentlichkeit immer wieder mit der Nase in die Wunde stoßen-was bleibt uns?	offense	profanity	none
Pünktlich zum Wahlkampfauftakt ziehen sich unsere politi. Raubtiere Berlins d. Lammfell über, um weitere Jahre im gleichen Trott zu agieren😜	offense	insult	none
Aus dem Seelenleben von A: Wir haben die Wahl zwischen Sch... und großer Sch.... B: Noch schlimmer. #spdbpt17ِ	offense	profanity	none
Blind ist die Meck-Pomm Schlampe auch noch!	offense	abuse	sexism
...Schade da ist mir jemand mit dem Wunsch Blitze beim scheissen zuvor.... Ralle du hast nicht viele Freunde....und es werden immer weniger....😃😃	offense	profanity	none
Das ist zum einen falsch, 2016 waren nur rd. 44% d. Asylbewerber*innen Männer ü18, zum anderen hat es gute Gründe, warum oftmals ein (das stärkste) Familienmitglied zuerst flieht. Schämen sollten sich, folgt man ihrer Argumentation, dann eher die, die Familiennachzug ablehnen.	none	none	sexism
Hmmm. Wenn ich es richtig sehe, bestreitet niemand das Problem einer Lücke bei gesicherter Kapazität in den 20ern... CL	none	none	none
Und wieso wurde dieses etwas nicht Zwangsverheiratet...?	offense	abuse	sexism
Raub Mord Vergewaltigung muss gesühnt werden...egal in welchem Land...Abschiebung erst nachdem diese Schweine ihre Strafe absitzen...!	offense	insult	none
Lachnummern, wie Papagei Tauber sind gut für`s Wahlergebnis. Merkel steht auf Leute oh. eigene Meinung u. mit NICHTS zw. d. Ohren 😜	offense	insult	none
Jetzt melden sich die Vasallen Merkels!	offense	insult	none
Schiebt die Linken direkt mit ab! 👍 😂😂😂😂	offense	abuse	none
Schreibt besser mal über die Asylanten Verbrechen ,dass wird bei euch totgeschwiegen!	offense	abuse	none
Gabriel ist widerlich und unverantwortlich. Wird Zeit, dass er schnellstens verschwindet	offense	insult	none
Kompliment, dass Sie für mehr E-mobility arbeiten! Ich werbe seit 5 Jahren dafür. Brauchen E-Cars für Städte!	none	none	none
Wer für das Recht und die Gerechtigkeit unter den Völkern demonstriert und gleichsam zu Gewalt gegen Juden aufruft, der ist klar zu verurteilen, der hat sein Recht auf Demonstration verwirkt und handelt im Widerspruch zum Recht - Islam ist antirassitisch #Jerusalem	none	none	none
Gottseidank lachen viele Deutsche schon lange über Merkels hohe kriminelle Energie. Verhindern sie es in FR 😜	offense	insult	none
Der kann nicht anders schreiben - seit 24 h. Hab mir seinen Acc. angesehen, der hat fast alle Follower aus D belegt. Bei den Amis zieht er den Schwanz ein - ach ja, ist eine sie😀	offense	insult	none
Wenn ich nachdenke,ist es schon erniedrigend im Lobbyisten.Babel Deutschland unter Führung der Finger kauenden Marionette leben zu müssen😜	offense	insult	none
Was ist das denn für eine, die Blonde mit Harry Potter Brille? Umso eher die AFD an die Macht kommt umso besser für Deutschland und deutsche Bürger. #illner	offense	insult	sexism
Selbstmordanschlag in Manchester, alle Medien geilen sich förmlich daran auf, ohne Ursachen zu erwähnen.	offense	profanity	none
Sigmar Dumpfbacke Gabriel gefällt mir richtig gut 🤡	offense	insult	none
Bundeskanzler #Kurz wird sicherlich nicht noch einmal bei Maischberger sitzen. Bei einer Frau ohne Anstand keinerlei Erziehung und Achtung vor Andersdenkende. Eine Heuchelnde Anhängerin der Diktatur das ist Frau Maischberger. #maischberger	offense	insult	sexism
